#################################################################
#***************************************************************#
#***************************************************************#
#***************************************************************#
#********#**********************#**********************#********#
#********#**********************#**********************#********#
#********#**********************#**********************#********#
#********#**********************#**********************#********#
#********#**********************#**********************#********#
#********#**********************#**********************#********#
#********#**********************#**********************#********#
#********#**********************#**********************#********#
#********#**********************#**********************#********#
#********#**********************#**********************#********#
#********#**********************#**********************#********#
#********#**********************#**********************#********#
#********#**********************#**********************#********#
#***************************************************************#
#***************************************************************#
#***************************************************************#
#***************************************************************#
#################################################################
*****************************************************************
*****************************************************************
*****************************************************************
*****************************************************************
*****************************************************************
*****************************************************************